NO ./textures/wall-1.png
SO ./textures/wall-4.png
WE ./textures/new-wall-5.png
EA ./textures/new-wall-3.png

F 40,220,0
C 40,220,220




        1111111111111111111111111
        1000000000110000000000001
        1011000001110000000000001
        100100000000000000000E001
111111111011000001110000000000001
1000000000110000 01110111111111111
11110111111111011100000010001
11110111111111011101010010001
11000000110101011100000010001
10000000000000001100000010001
10000000000000001101010010001
1100000111010101111101111000111
11110111 1110101 101111010001
11111111 1111111 111111111111