NO ./textures/north-img.png
SO ./textures/south-img.png
WE ./textures/west-img.png
EA ./textures/east-img.png

F 40,220,0
C 40,220,220

1111111111111111111
1000000000010000011
1001110000110100001
1001000011000000111
1000100111000010001
10N0000100000100011
1000000111110001001
1111000000011100001
1000000000000010001
1001111000111000101
1000100001000010001
1110000111100011101
1000000000000000011
1000111000011100001
1010001000010001111
1000000100000000001
1111100111001110001
1000000000000000111
1011000000111000101
1000000111000000001
1111111111111111111
