NO ./textures/wall-1.png
SO ./textures/wall-4.png
WE ./textures/new-wall-5.png
EA ./textures/new-wall-3.png

F 40,220,45
C 40,220,220

11
111
 1
11
111
1111
1N111
111111