NO ./textures/north-img.png
SO ./textures/south-img.png
WE ./textures/west-img.png
EA ./textures/east-img.png

F 40,220,45
C 40,220,220




111111111111111111111
100000000000000000001
100000000000000000001
100000000000000000001
100000000000000000001
100000000000000000001
100000000000000000001
100000000000000000001
100000000000000000001
100000000000000000001
1000000000N0000000001
100000000000000000001
100000000000000000001
100000000000000000001
100000000000000000001
100000000000000000001
100000000000000000001
100000000000000000001
100000000000000000001
100000000000000000001
111111111111111111111