NO ./textures/north-img.png
SO ./textures/south-img.png
WE ./textures/west-img.png
EA ./textures/east-img.png

F 204,204,204
C 153,204,255

1111111111111111111111111111111111111111
1000000000000000000000000000000000001001
1000111100000000000000000000000001000001
1000111100000000000000000000000001111111
1000111100000000000011100000000000000001
1000111100000000000011100000000000000001
1000000000000000000011100000000000000001
1000000000000000000000000000000000000001
1000000000000010101000000000000001111111
100001100000000101N100000000000001111111
1000011100000000000000000000000000000001
1000011000000000000000000000000000000001
1111111111111100000000000000000000000001
1111111111111100000000000000000000000001
1000000001100000000000000111100000000001
1000000001100000000000000111100000000001
1000000001100000000000000111100000000001
1000000000000000000000000000000000000001
1000000000000000000000000000000000000001
1111111111111111111111111111111111111111