NO ./textures/north-img.png
SO ./textures/south-img.png
WE ./textures/west-img.png
EA ./textures/east-img.png

F 40,220,45
C 40,220,220

1
11
111
1111
1N111
111111