NO ./textures/north-img.png
SO ./textures/south-img.png
WE ./textures/west-img.png
EA ./textures/east-img.png

F 220,100,0
C 225,30,0




1111111
1100011
1000011
1100011
110N011
110N011
1111111