NO ./textures/wall-1.png
SO ./textures/wall-6.png
WE ./textures/wall-3.png
EA ./textures/wall-5.png

F 220,100,0
C 225,30,0




        1111111111111111111111111
        1000000000110000000000001
        1011000001110000000000001
        1001000000000000000000001
111111111011000001110000000000001
1000000000110000 01110111111111111
11110111111111011100000010001
11110111111111011101010010001
1100000011010101110000   0010001
1000000000000000110000 1 0010001
1000000000000000110101   0010001
11000001110101011111011110N0111
11110111 1110101 101111010001
11111111 1111111 111111111111