NO ./src/images/wall2.png
SO ./src/images/wall.png
WE ./src/images/wall3.png
EA ./src/images/exit.png

F 40,220,45
C 40,220,220




111111111
100000001
100000001
10N000001
100000001
100000001
111111111