NO ./src/images/wall4.png
SO ./src/images/wall4.png
WE ./src/images/wall4.png
EA ./src/images/wall4.png

F 40,220,45
C 40,220,220




11111
10001
10001
10N01
10001
10001
11111