NO ./textures/wall-1.png
SO ./textures/wall-4.png
WE ./textures/wall-6.png
EA ./textures/wall-5.png
n

F 40,220,45
C 40,220,220

n

11 111111
10 000001111
10 0110000001
10 01 1000000111
10 0010011100001
10 0000000000001
10 N00001 100111
10 00000110101
 1 11100000001
10 00000000001
10 101110100001
10 001 1001101
 1 11   11  1
