NO ./textures/north-img.png
SO ./textures/south-img.png
WE ./textures/west-img.png
EA ./textures/east-img.png



11111111
10000001111
100110000001
1001 1000000111
100010011100001
10N00001 100111
1000000110101
 111100000001
1000000 000001
10101110100001
10001 1001101
 111   11  1

F 40,220,0
C 40,220,220

